################
################
#   ##    ##   #
#   ##    ##   #
#   #      #   #
#   #      #   #
#   #      #   #
#   #      #   #
#   #      #   #
################
################
################
