###################
# #  #         #    #
#  #  #        #    #
#   #  #       #    #
#    #  #      #    #
#     #  #     #    #
#      #  #    #    #
#    #  #  #        #
#    #     #     #  #
#    #      #     # #
#    #     #    #   #
###################

