###################
# #  #         #    #
#  #  #   e    #    #
#   #  #       #    #
#    #  #      #    #
#     #  #     #  p #
#      #  #    #    #
#    #  #  #        #
#    #     #     s  #
#    #      #     # #
#    #     #    #   #
###################

