#####################
# #  #         #    #
#                   #
#               e   #
#                   #
#                   #
#                   #
#                   #
#                   #
#   s               #
#               #   #
#####################

