#####################
# #  #         #    #
#                   #
#   p           e   #
#                   #
#                   #
#                   #
#                   #
#                   #
#   s               #
#               # k #
#####################

