#####################
#s                  #
################### #
#                   #
# ###################
#                   #
################### #
#                   #
#####################
#                   #
#                  e#
#####################
