#####################
#s                  #
################### #
#                   #
# ###################
#                   #
################### #
#                   #
#####p###############
#                   #
#k                 e#
#####################
