 #####    e        #
 #                 #
 ###   #   #  ###  # #
 #     #   #  #    ##
 #      ###   ###  # #
                      ###
 #####                #
 #       ##     ##    ##
 #   #  #  #   #  #   #
 #####   ## #   ##    ###
                  #
                  #
      s           #
                ##
