#####################
#s                  #
#  ##############p   #
#  #         k  #   #
#  ####         #   #
#     #         #   #
#     #######       #       
#           #       #
#  ##########       #
#                   #
#                e  #
#####################
